00####0000
###0@0####
#00$$$000#
#000.0000#
##00000###
#0.000.0#0
#0000000#0
#########0