0#######0
0#00@00#0
0#0$0$0#0
0#0.$.0#0
##.0#0.##
#000$000#
#0000000#
#00###00#
####0####