000####00
####00##0
#000$00#0
#000000#0
#00.0.0##
##000000#
0##00000#
00#0$0###
00#0@0#00
00#####00